aba aba - aba aba, prentah
diberi aba aba - diabani
minta aba aba - abanono
abab - hawa sing metu saka cangkem,gudhal,(jigong -Bhs Indonesia)
abad - abad
abadi - langgeng
abah - bopo, romo,bapak,pa'e
abai - nengne, tegke, lirwa, jar
diabaikan - dilirwakake, ora digape, dinengne, ditegke, dijarake
mengabaikan - nglirwakake, ngejarake
abang - mas, kakang, kangmas, raka,merah (warna)
abangan - wong Islam nanging ora nglakoni salat,gelem nyembah/njaluk/dedonga marang kuburan/keramat/petilasan
mengabar - ngabar, ilang ambune, ilang dayane
abdas, wudu - wudu
abdi - abdi, batur, kawula, rewang, punggowo rencang
mengabdi - ngabdi, ngawula
abjad - abjad, aksara
ablak - menga amba tumrap cangkem utawa lawang
abnormal - ora normal
abon - abon
abonemen - lengganan
abortus - miskram, kluron
abrak - piranti, prabot, bekakas
abras, lepra - budhug, lepra
absah - sah, resmi
absen - ora teka, ora mlebu, nglimput
abses - abuh ngemu nanah, mborok
abu - awu, lebu
abu abu - klawu
acak - awur, sembarang, nyekarep
acak acakan - awur awuran, kaco
acap, sering - kerep, Asring, gelek (bhs. malang sekitarnya)
acar - acar
acara - acara
acuh - nggatekake, perduli
tak acuh - ora nggatekake
mengacung - ngacung
ada - ana, wonten
ada ada saja - ana ana wae
mengada ada - gawe gawe , damel damel
keadaan - kahanan, kaanan
diadakan - dianakake
mengadakan - nganakake
seadanya - sak anane
adab - unggah ungguh, tata krama
adakalanya - anakalane , sok sok
adalah, yaitu - yaiku, yakuwi,inggih puniko
adan, adzan - adan
adang - cegat
diadang - dicegat
mengadang - nyegat, ngadhang
adat - adat, tatacara, pranata
adegan - adegan, lelaku
adem, dingin - adhem, asrep
adigung - adigung
adik - adhi, rayi, dhimas
adik saya - adhiku, rayi kula
adil - adil, bagirata
adinda - adhimas
adipati - adipati
administrasi - administrasi
admiral - se napati lautan
mengadoni - ngadoni
adonan - adonan
adpertensi - iklan, re klame
adres - adres, alamat
adu, lomba - adu, tandhing
aduan - adon
beradu - gathuk
mengadu - ngedu, wadul
peraduan - peturon
aduh - adhuh
aduhai - dhuh, wadhuh
aduk - adhuk, udhek
mengaduk - ngadhuk
mengaduk aduk - ngadhuk adhuk
advis - pitutur
advokat - pokrol, adpokat
afiat - waras, sehat
agak - rada , radi
agak gemuk - rada lemu
agaknya - kaya kaya, katone
agama - agama, agami
agar - supaya, supados
agar agar - ager ager
agen - agen
agenda - agendha, acara
agun, agunan - tanggungan, bong
agung - agung, luhur, gedhe
diagungkan - diagungake
mengagungkan - ngagungake
ahad - Ahad. 'Soma Minggu (nama hari)
ahli - linuwih, pinter, tukang
ahmak - bodho, goblok,gendheng
aib - celo, nistha
air - banyu, toya, tirta
air bah - banjir
air hidung - umbel
air liur - iler
air limbah - peceren
air terjun - grojogan
air panas - banyu panas
air seni - uyuh, turas
air soda - banyu landa, sodha
ajaib - ajaib, aneh
mengajak - ajak, ngajak
ajal - ajal, mati, seda, pralaya, matek, modar
ajang perang - palagan
ajar - ajar, uruk, ulang
mengajar - mulang, muruk
kurang ajar - murang tata
pelajaran - pawulangan
pelajar - murid, siswa
ajeg - ajeg, utuhTeks tebal'Teks miring
ajengan - ajengan,kyai,ulama
aji aji - aji aji, kasekten
mengaji - ngaji
mengajukan - ngajokake
ajudan - ajudan
akal - akal, bebuden
akan - arep, badhe
seakan akan - kaya kaya, katone
akang, kakang - kakang, kangmas, roko
akar - oyot
akar tunggang - oyot lajer
akar bahar - akar bahar
berakar - ngoyot
akad - prajanjen
akas - trengginas, cukat
akbar - agung ,gedhe
akhir - akir, pungkasan
akhirnya - pungkasane
berakhir - rampung, entek, bubaran
akhirat - akerat
akhlak - ahlak, moral
aki - mbah
akibat - akibat, dadine
batu bancang - watu akik
akor - akur, rukun
akrab - raket, cedhak
akrobat - akrobat
aksara - aksara
aksen - aksen, logat
aksi - aksi, tandang
akta, akte - akte
aktif - sregep, giyat
aku - aku, kula, dalem
mengaku - ngaku
akuarium - akuarium
akuntan - akuntan
akur - rukun, sarujuk,jumboh
akurkan - ngrukunake
diakurkan - dirukunake
mengakurkan - ngrukunake
akurat - titi, tliti, tlesih
ala, cara - cara, manut
ala kadarnya - sakadhare
alabangka - linggis
alam - alam, bumi, buwana
mengalami - ngalami, nglakoni
pengalaman - pengalaman
alamat - alamat
alang, halang - palang
alang alang - alang alang
alangan - alangan
menghalangi - ngalangi
alangkah - dhuh, mendah
alas, dasar - dasar, lemek, dhampar
alasan - alesan
alas meja - taplak
alat - perkakas,
album - album
alem, sanjung - alem, puji
aleman - aleman,manja
alergi - alergi
algojo - algojo, jurupati
ali ali - plintheng
alias - alias
alih, pindah - ngalih, pindhah
memindahkan - ngalihake
alim - anteng, alim
alir - mili, kocor
mengalir - mili, ngocor
mengaliri - ngileni, ngocori
mengalirkan - ngilekake
aliran - ilen, iline
alis - alis, imba
aljabar - aljabar
alkohol - alkohol
allah - Gusti Allah
almanak - tanggalan, amanak
almarhum - jenat, swargi
almari - lemari, lemantun
alpa, lupa - lali, kesup en
alu, antan - alu
alum - alum, layu
alun, ombak - alun, ombak
alun alun - alun alun
ama, hama - ama
amal - amal
amalan - amalan
diamalkan - diamalake
mengamalkan - ngamalake
aman - aman, tentrem
keamanan - keamanan
amanat - weling, amanat
amandel - amandhel
amarah - nesu, duka
amat, sangat - banget, sanget
amat jauh - adoh banget, tebih sanget
amat sakit - lara banget
mengamati - nliti, maspadakake
amatir - amatir
ambal - ambal, babut
ambeien - bawasir, dobol
ambil - jupuk, pundhut
ambilkan - jupukna, pundhutaken
mengambil - njupuk, mundhut
amblas - ilang, ambles, ical
ambrol - ambrol, bobol
ambruk - tibo, ambruk, rubuh
amis - amis
amit, pamit - pamit, nyuwun pamit
ampas - ampas, sepahan
ampela - rempela
ampelas - amplas, amril
ampuh - ampuh, sekti
ampun - ampun. tobat, kapok
amril - amril, amplas
amsal - conto, upama
amtenar - priyayi, punggawa
auk - amuk
mengamuk - ngamuk
diamuk - diamuk
anai anai - rayap
anak - anak, putra,atmaja
anak anak - bocah bocah, lare lare
beranak - babaran, manak
ngambil anak - mupu anak
anasir - unsur
ancak - ancak
ancam - ancem
diancam - diancem
mengancam - ngancem
ancang ancang - ancang ancang
ancuk - sanggama, saresmi
anda - kowe , panjenengan
andai kata - umpama, umpami
seandainya - saumpamane
andalan - andel, piandel
diandalkan - diandelake
andang, obor - obor, colok
andeng andeng - andheng andheng
andil - urun, andhil
andong - andhong, dhokar
anduk - andhuk
aneh - nyele
aneka - werna werna,maneko warno
angan angan - angen angen
anggap - anggep
menganggap - nganggep
anggapan - panganggep
anggar - anggar
anggota - anggota, warga
angguk - anthuk
mengangguk - manthuk
mengangguk angguk - manthuk manthuk
anggukan - anthukan
anggun - anggun
angin - angin, bayu
angin ribut - lesus
berangin angin - ngisi
angka - angka
angkara - angkara, murka
angkasa - angkasa, awang awang
angkat - angkat, junjung
berangkat - mangkat, budhal
mengangkat - ngangkat, nggawa
angker, serem - angker, wingit
angker, jangkar - jangkar
angkin, setagen - angkin, setagen
angkuh - anggak, dumeh
angkut - angkut, usung
angkutan - angkutan, gawan
diangkut - diangkut
mengangkut - ngangkut, ngusung
anglo - anglo
angon, ngangon - angon, ngangon
angsa - banyak
mengangsur - cicil, nyicil
angus - angus, geseng
aniaya - aniaya
menganiaya - nganiaya, milara
anjak, beranjak - ngalih, mingset
anjing - asu, segawon
anak anjing - kirik
anjur - anjur, kongkon
dianjurkan - dianjurake
anjuran - anjuran
antan - alu
antar - terke, dherekake
diantarkan - diterake
mengantar - ngeterake
antara - antara. elet
di antaranya - antarane
perantara - kongkonan
anteng, tenang - anteng
anti - anti, tolak, emoh
antik - antik, kuno
anting - anting anting
antre - antri
terantuk - kejadhus, kejedhuk
anus, dubur - silit, dubur
anugerah - anugerah, nugraha
anut, menganut - nurut, melu, nganut
anutan - panutan
anyam - anyam, enam
anyaman - anyaman
menganyam - nganyam, ngenam
anyar, baru - anyar, Vnggal
anyelir - anyelir
anyir, amis - amis, arus
apa - apa, punapa
diaoakan - dikapakake
mengapa - kena apa
apa apaan - apa karepe
apabila - yen, mbok manawi
apak (bau)- apek, penguk
apalagi - apamaneh
apam, apem - apem
aparat - piranti, alat
buah apel - apel
apes, sial - apes, sial, cilaka
api - geni, latu
apik - apik, sae, asri
apit - apit, jepit
diapit - diapit, dijepit
mengapit - ngapit
apkir - pekir, ora kanggo
buah apokat - apokat
apotek - apotik
apung - kambang, kampul
mengapung - ngambang, ngampul
arah - arah, ener, tuju
mengarah - tumuju
arak, tuak - arak, tuak
arak arakan - arak arakan
mengarak - ngarak, ngiring
diarak - diarak
aral, halangan - aral, alangan
aram temaram - surem, remeng remeng
arang - areng
arbei - arbei
arca - reca
arek - bocah
aren, enau - aren
arena - papan, kalangan
kulit ari - kulit ari
ari ari - ari ari, embing embing
arif - arif, wicaksana
aris, tepi - pinggir
arisan - arisan
arit - arit
arloji - arloji, jam
arnal - arnal, susuk kondhe
aroma - ambon ambon
aron, megaron - ngaron
arpus, damar - arpus, damar
arti - arti, teges, makna
artis - artis, seniman
mengarungi - nyabrang, njelajah
arus - mili, milir
arwah - roh, nyawa, arwah
as, poros - as
asa - karep, karsa
putus asa - nglokro
asah - asah
batu asahan - ungkal
mengasah - ngasah
asal - sangka ,asal
asalkan - angger, anggere
asalnya - asale, sangkane
asal usul - asal usul
berasal - asale saka, saking
asam - asem (wit)
asam (rasa) - kecut
asap - asep, kukus, kebul
berasap - kumebul
asar - asar
asbes - asbes
asih - asih, tresna
mengasihi - nresnani
asin - asin
asing - aneh, seje, beda
asisten - asisten, pembantu
asli - asli
asma - mengi, mengguk
asmara - asmara, sengsem
aso, istirahat - aso, leren, ngaso
asrama - asrama, pondhokan
asri - asri, endah
asuh - emong, dhidhik
mengasuh - momong, ngemong
asuhan - momongan
asyik - karem
atap - payon
atas - dhuwur, inggil
diatas - ing dhuwur
ke atas - munggah
mengatasi - mrantasi
atau - utawa
aturan - tatanan, pathokan
mengatur - mernata
peraturan - tatanan, pathokan
aur, bambu - pring
aurat - aurat
aus - kagesrek, gerang
awak - awak, badan, salira
awal - wiwitan, kawitan
awalnya - dhisike, mulane
awan - mega, mendhung
awang awang - awang awang
awas - premana, waspada
pengawas - mandhor
mengawasi - ngawasi
awet - awet
awur, ngawur - awur, ngawur
ayak, mengayak - ayak, nyaring
ayakan - ayakan
ayam - pitik
anak ayam - kuthuk
ayam alas - ayam alas
ayem, tenteram - ayem, tentrem
ayah - bapa, rama
ayan - ayan
ayat - ayat
ayo, mari ayo
ayu, cantik - ayu, elok
ayunan - gandhulan
azab, siksa - siksa, pasiksan
bab - bab
babad - babad, riwayat
babak belur - babak bundhas
babar, beber - mbeber
babat (daging) - babat
babat (tebang) - babat, tegor
membabat - mbabat
babi - babi, srenggono
babon, induk - babon
babu - rewang, batur, abdi
babut - babut
baca - waca, waos
bacaan - wacan, waosan
membaca - maca, maos
dibacakan - diwacakake
bacin, bau - basin, bacin
bacok - bacok, kethok
membacok - mbacok, ngethok
badai - lesus, ampuhan
badak - badhak, warak
badan - awak, salira, badan
menyebadani - saresmi
badung, nakal - nakal, ndhugal
badut - badhut, lawak
bagai - kaya, kados
bagaimana - kepriye, kados pundi
bagal jagung - janggel
bagi - dum, bagi
bagian - bagean, perangan
dibagi - didum
membagi - ngedum, mbagi
kebagian - keduman, kebagean
sebagian - saperangan
pembagian - dum duman
bagus - becik, apik, sae
bahagia - bagya, seneng, bungah
terbahak - ngakak
bahan - bahan, bakal
bahasa - basa
bahaya - bebaya
berbahaya - ngemu bebaya, mbebayani
bahenol - semok
bahkan - malahan
bahtera - kapal, prau
bahu, pundak - bahu, pundhak
bahwasanya - satemene, sakbenere
baik - apik, sae
memperbaiki - mbenerke, ndandani, mbenakake
sebaiknya - apike
baja - waja
bajak, luku - waluku, singkal
bajak, rampok - kecu
bajing, tupai - bajing
bajingan - kecu, bangsat
baju - klambi, rasukan
baka, kekal - baka, langgeng
bakal - bakal
bakar - obong
kebakaran - kobongan, kabesmi
dibakar - diobong
membakar - ngobor, mbakar
bakau, pohom - bakau
bakhil, kikir - medhit, cethil
baki, talam - baki, talam, tembor
bakiak - bakiak, theklek
bakmi - bakmi, mi
bakso - bakso
bakteri - bakteri
bakti - bekti
berbakti - ngabekti
bakul nasi - wakul
bal, bola - bal
bala, prajurit - bala, prajurit
balai - bale
balai balai - amben
balairung - bangsal
balapan - balapan
balar, bule - bule
balas - bales, wales
membalas - mbales
balasan - balesan, piwales
balatentara - perjurit
balian, dukun - dhukun
balik - walik
membalik - malik
terbalik - kuwalik
sebaliknya - suwalike
baliq - diwasa, baleq
balok - balok
balon - balon, plembungan
baling baling - kitiran
balsam - balsem
balu - randha/dudha
balut - blebet
membalut - mblebet
bambu - pring
ban - ban
banci - banci, wandu
bandar - bandar
bandel - bandhel
bandeng - bandeng
banding - bandhing
bandingkan - bandjingna
sebanding - sakbandhing
dibandingkan - dibandhingake
bandit - bandhit, bangsat
bangau - blekok, cangak
bangga - mongkok, bombong
bangkai - bangke, bathang
membangkang - nglawan, mbalela
bangkrut - kukut, bangkrut
bangku - bangku
bangkuang - bengkowang, besusu
bangor, jahil - nakal, jail
bangsa - bangsa
bangsal - pendhapa
bangsat - bajingan, kecu
bangsawan - ningrat
bangun (bentuk) - wangun, wujud
bangunan - wangunan
membangun - mangun, mbangun
bangun (tidur) - tangi, wungu
membangunkan - nangekake, nggugah
banjir - banjir, bena
bantah - bantah, ngangkal
membantah - mbantah
bantai - tumpes
bantal - bantal
bantat - bantat
banteng - bantheng
banting - banting, kepruk
membanting - mbanting, ngepruk
dibanting - dibanting
bantu - rewang, tulung
membantu - nulung
pembantu - batur, rencang
banyak - akeh, kathah
memperbanyak - ngakehake
kebanyakan - kakehan
membanyol - mbanyol, ndhagel
bapak - bapa, rama
bara api - mawa
barang - barang
barangkali - mbokmenawa, mbokmenawi
barat - kulon, kilen
bareng - bareng, sareng
berbaring - glethakan, teturon
membaringkan - nurokake
terbaring - gumlethak
pembaringan - peturon
baris - baris, larik
barisan - larikan
berbaris - baris
barongan - barongan
barongsai - barongsai
baru - anyar, enggal
barusan - lagi wae, nembe
membarui - nganyarake
basah - teles
membasahi - nelesi
basah kuyup - teles klebes
basa basi - tatakrama
basi, nasi basi - wayu, mambu
basi, cawan - mangkok
basil - baksil
basis, dasar - asas, dhasar
basis, pangkalan - pangkalan
bola basket - basket
baskom - baskom
basmi - besmi, brastha
membasmi - mbesmi, mbrastha
basuh - wasuh, kumbah
membasuh - ngumbah
bata - bata, banon
batako - batako
batal - batal, wurung
membatalkan - mbatalake, murungake
batalion - batalion
batang - pang
batara, dewa - bathara, dewa
batari, dewi - bethari, dewi
batas - wates, bates
dibatasi - dibatesi, diwatesi
membatasi - mbatesi, matesi
baterai - batre, senter
batik - bathik
membatik - mbathik
batil, batal - muspra, batal
batin - batin, batos
batok kelapa - bathok
batu - watu, sela
berbatu batu - akeh watune
batuk - watuk, cekoh
berbatuk - watuk
terbatuk batuk - watuk watuk
bau - ambu, ambet, ganda
berbau - mambu, mambet
bau busuk - bacin, banger
bau bauan - wewangen, ambon ambon
baur, berbaur - campur, amor, awor
baut - baut
bawa - gawa, mbekta
membawa - nggawa, ngasta
membawa di kepala - sunggi, nyunggi
pembawaan - bakat, sifat
membawa bawa - ngembet embet
bawah, dibawah - ngisor, ing ngisor
paling bawah - ngisor dhewe
bawang - bawang
bawang merah - brambang
bawang putih - bawang
bawel - crewet, criwis
baya, sebaya - sepantar
bayam - bayem
bayangan - wewayangan
bayang bayang - ayang ayang
membayangkan - mbayangke
terbayang - katon katonen
bayar - bayar
bayaran - bayaran
membayar - mbayar
pembayaran - mbayare
bayi - bai
bayonet - bayonet
bayu, angin - angin, pawana
bazar - basar, pasar amal
beasiswa - beasiswa
bebal, dungu - bodho, bebel
beban - sanggan
membebani - ngebot ngeboti
bebas - bebas
membebaskan - mbebasake
bebat - perban, blebet
membebat - merban, mblebet
bebek - bebek, kambangan
beber, membeberkan - mbeberake
becak - becak
becek - jemek, jeblok
becus - bisa, saget
beda - seje, beda, benten
dibedakan - dibedakake
membedakan - mbedakake
berbeda beda - beda beda
bedah, operasi - bedhah, bedhel
membedah - ngoprasi, mbedhel
bedak - wedhak, pupur
bedil - bedhil
membedil - mbedhil
beduk - bedhug
begal, dibegal - begal, jegal, bihal
membegal - mbegal
begawan - pandhita, bagawan
begini - mangkene, ngene
begitu - mengkono, ngono
bejana - bak
bejat - bejad, rusak
bekal - sangu
membekali - nyangoni
bekas - tilas, tapak
membekas - nabet, nipak
barang bekas - rombengan
bekatul - katul, bekatul
beker, jam beker - beker
bekicot - bekicot
bekisar - bekisar
beku, membeku - njendhel
bekuk - tekuk
bel - bel
bela - bela
dibela - dibela
membela - mbela
belacan, terasi - trasi
belacu, kain - blacu
belah - sigar
membelah - nyigar, miyak
belahan - sigaran
sebelah - sesisih, sisih
sebelah timur - sisih wetan
belai, membelai - ngelus elus
belajar - sinau
belaka - amung
belakang - mburi, wingking
belakangan - tembe, mburine
di belakang - ing mburi
ke belakang - menyang mburi
membelakangi - ngungkurake
membelalak - mblalak, mendelik
belalai - tlale
belalang - walang
belanak - blanak
belanda - Walanda, Landa
belang - belang, blontheng
belanga - kuwali
belangkin - tir, aspal
belangko - blangko
belanja - blanja
berbelanja - blanja
belanjaan - blanjan
belantara - alas gedhe
belas kasih - welas asih
belas, sebelas - sewelas
belati - glathi, lading
belatung - blatung, set
belenggu - belok, kecrek
membelenggu - mbelok, mblenggu
terbelenggu - kebelok, keblenggu
belerang - wlirang
beli - tuku, tumbas, mundhut[1]
dibeli - dituku, ditumbas, dipuntumbas
membeli - tuku, tumbas, mundhut
membelikan - nokokake, mundhutaken
belia - enom, taruna
membeliak - mentheleng
beliau - piyambakipun
belibis - mliwis
belimbing - blimbing
belinjo - mlinjo
beling - beling (ceples)
belit, lilit - rambat, mrambat
berbelit belit - mbulet
belok - menggok
dibelokkan - dienggokake
berbelok - menggok
berbelok belok - menggak menggok
belokan - penggokan
belukar - grumbul
beluluk - bluluk
belum - durung, dereng
sebelumnya - sadurunge, sakderengipun
belunjur - slonjor
beluntas - luntas
belut - welut
benah, membenahi - nata, mberesi
benak - utek
benalu - kemladeyan
benam - lelep, klelep, delep
membenamkan - nglelepke
terbenam - klelep, angslup (tmr srengenge) [2]
benang - benang, bolah, lawe
benar - bener, leres
sebenarnya - sakbenere
membenarkan - mbenerake
bencana - pageblug, bilahi
benci - gething, serik
dibenci - disengiti
membenci - nyengiti
kebencian - rasa sengit, gething
benda - barang
bendel - bendhel
membendel - mbendhel
bendera - gendera
bendi, dokar - dhokar, andhong
bendungan - wadhuk, bendungan
bengawan - bengawan
bengek, asma - mengi, mengguk
bengis - wengis, galak
bengkak - abuh
terbengkalai - thether, kethetheran
bengkel - bengkel, bingkil
bengkok - bengkong
bengkuang - bengkoang, besusu
bengkudu, pace - pace
bengong - bengong, mlongo
benih - winih, wiji, bibit
bening - bening, resik
benjol - benjol, menyonyo
bentak - getak, sentak
dibentak - digetak, disentak
membentak - nggetak, nyentak
membentang - penthang
sebentar - sadhela, sekedhap
bentrok - tawur, padu
bentuk - wujud, wangun
bentul - bentul, tales
bentur - tubruk, terak
benturan - tubrukan
dibenturkan - ditubrukake
terbentur - ketubruk, kejedhus
membentur - nubruk, njedhus
benua - bawana, buwana
benyek - mlenyek, mlenyeh
beo, burung - beo, menco
beol - ngising, bebucal
berahi - brahi, kasmaran
berak - ngising, ngengek, bebucal
beranda - pendhapa. emperan
berandal - brandhal
berang - muring, kanepson
berang -berang - berang berang
berangasan - brangasan
berangkat - mangkat, budhal
berangus - brangus
berani - wani, kendel
pemberani - kendel
berantakan - bekakrah, ambyar
berantam - gelut, tukaran
berantas - brantas, brastha
berapa - pira, pinten
seberapa - sepira
beras - beras, wos
beras ketan - beras ketan, ketos
berat - abot, awrat
memberati - ngeboti
keberatan - kabotan, kawratan
bercak bercak - totol totol
berdiri - ngadeg, jumeneng
berengut - mrengut, nesu
beres - beres, rampung
berewok - brewok
bergedel - bergedel, bregedel
berhala - brahala, reca
beri - weneh, paring, caos
diberikan - diwenehake
memberi - menehi, maringi
pemberian - paweweh, paringan
beri beri - beri beri
beringas, buas - ringas, galak
berisik - gemrenggeng
berita - warta, kabar, wartos
berkat, [[]] - berkat
berlian - barlian, inten
bernas, berisi - mentes
berontak - nraman, brontak
bersih - resik
membersihkan - ngresiki
kebersihan - karesikan
bersih bersih - reresik
bersin - wahing
beruang - beruang
berudu - cebong
besar - gedhe, ageng
membesarkan - nggedheake
dibesarkan - digedhekake
besaran, murbei - murbei, besaran
besek - besek
beser - beser
besi - wesi, tosan
besi sembrani - wesi sembrani
membeslah - mbeslah
beslit - beslit
besok - sesuk, mbenjang
besok besok saja - sesuk sesuk wae
besot, beset - beset, mlecet
besuk - besuk, tilik
besusu - bengkoang
betah, kerasan - betah, krasan
betapa - mendah
betara - bathara, dewa
betari - bathari, dewi
betina - wadon, wedok, babon
betis - kentol, wentis
betot, cabut - bethot, dudut
betul - bener, leres
kebetulan -kebeneran, kaleresan
sebetulnya - sakleresipun
membetulkan - mbenerake
biang - babon, biyung
bianglala - kluwung, layung
biar - bene, jarna, ben
dibiarkan - dijarna, tokna
dibiarkan saja - jarna wae
biasa - biasa, lumrah
biasanya - biasane, adate, umume
kebiasaan - pakulinan
membiasakan - ngulinakake
terbiasa - kulina, manuh
biawak - menyawak
biaya - ragad
bibi - bibi, bibek, bulik
bibir - lambe, lathi
bibit - winih, wiji
bicara, berbicara - ngomong, ngendika
bidadari - widodari
bidan -bidhan
membidik - ngincer
biduk - sampan, jukung
biduan - penyanyi
bijaksana - wicaksana
bijan - wijen
biji - wiji, isi
kue bikang - bikang
bikin - gawe, damel
membikin - nggawe, ndamel
bikinan - gawean, damelan
bikir - prawan
biksu - pendhita Budha
bila, kalau - yen, menowo, lek, menawi
bilah, sibak - wilah
bilal - tukang adan
bilang - ngomong, ngendika
bilangan - wilangan, etangan
terbilang - bisa diwilang
membilas - mbilasi, nggrirahi
bilik - senthong, kamar
bilis - melen, lara mata
bilur - bilur
bilyar - bilyar
bimbang - mangu mangu, kewuhan
bimbing - tuntun
dibimbing - dituntun
membimbing - nuntun, muruki
bimbingan - tuntunan
bina, membina - ndhidhik, mbangun
binal - rongeh, mbedhal
berbinar - sumunar, sumringah
binasa - tumpes, binasa
binatang - sato, kewan
binatu - binatu, penatu
berbancang bancang - renbug, rembugan
ingar bingar - rame banget
bingkai - wingku, pigura
bingkas - cepet, gelis
bingkisan - wungkusan
bingung - bingung
membingungkan - bingungake
bini - bojo, istri, garwa
bintang - lintang
bintik bintik - plenik plenik
bintil - bintul
biola - biola, piyul
birahi - brahi, birai
biri biri - wedhus gibas
terbirit - sipat kuping
biru - biru
bis, bus - bis
bisa, dapat - bisa, saged
bisa, racun - wisa, racun, upas
bisan - besan
bisik - bisik, klesik
berbisik - bisik bisik
dibisiki - dibisiki
membisiki - mbisiki
bising - bising, mbrenegi
bisu - bisu
membisu - meneng wae
bisul - wudun, kukul
ber*bisulan - wudunen, kukulen
biting - biting
bius, membius - mbius
blangkon - blangkon
blaster - pranakan, campuran
bobok, tidur - bobo, turu, tilem, sare
bobol, jebol - bobol, jebol, bedhah
membobol - mbobol, njebol
kebobolan - kemalingan
bobot, berat -bobot, abot, awrat
bobrok - rusak, bubrah, bibrah
bocah - bocah, lare
bocor - bocor, trocoh
kebocoran - ketrocohan
bodoh - bodho, goblok
bodor - bsdut, dhagelan
bogel, bugil - wuda blej
bogem mentah - jotos, anteman
bogi, dhokar - dhokar, bendhi
bohong - apus, goroh, dora[3]
dibohongi - diapusi, digorohi
membohongi - ngapusi, nggorohi
bokong, pinggul - bokong
boksen - tinju
bol, jambu bol - jambu bol
bola - bal
mata bolak - mblalak
bolak balik - wira wiri
boleh - entuk, oleh, angsal', pareng, kepareng
memperbolehkan - ngidini, marengaken'
bolong - bolong
berbolong bolong - pating cromplong
bolos - bolos
membolot - merban, mbebed
bonceng - bonceng, nunut
membonceng - mbonceng, nunut
berbondong bondong - pating grombol
boneka - boneka, golekan
bong - bong, tukang supit
bongkar - jebol, bongkar
dibongkar - dijebol, dibongkar
membongkar - njebol, mbongkar
bongkok - bungkuk, wungkuk
bongkot - bonggol
bonsai - bonse
bongsor - bongsor, longgor
bontot - ragil, wuragil
bonus - presen, persen
bonyok - bonyok, tatu
bopeng - burik
membopong - bopong, mbopong
bor - bor
bordir - bordir, sulaman
boreg - tanggungan
borgol - kecrek, blenggu
borok - borok, koreng
memborong - borong, mborong
boros - boros, royal
bosan - bosen, jeleh
membosankan - mboseni, njelehi
botak - brundul, buthak
botol - gendul
boyongan - boyongan, pindhahan
brangkas - lemari wesi
buah - woh
berbuah - awoh
 buahan - woh wohan
 dad -susu, payudara
 pelir - pringsilan
 hati - kekasih
 pinggang - ginjel
buai, ayun - ayunan
buaian - bandulan
bual, membual - ndopok, ndobos, umuk[4]
buana - bawana, donya, bumi
buang - guwang, bucal
membuang - ngguwang, ngguwak
 air besar - ngising, bebucal
 air kecil - nguyuh
 muka - mlengos
terbuang - kebuwang
dibuang buang - diguwak guwak
buas - galak, ringas
buat, untuk - kanggo, kagem
buat, cipta - gawe, damel
buatan - gaweyan, damelan
dibuat - digawe, dipundamel
membuat - nggawe, ndamel
buaya - baya, bajul
bubar - bubar, bibar
membubarkan - mbubarake
bubuk - bubuk
bubungan - wuwungan
bubue - bubur
bubul - bubul
bubut, cabut - bubut, mbubuti
mesin bubut - mesin bubut
bucu, pojok - pojok
budak - budhak, batur
budek - budheg, jampeng
budi pekerti - watak, budi pekerti
buduk, kusta - budhug, kusta
bufet - bufet
segar bugar - seger, bagas
bugenfil - bugenfil
buhuk - gondok
buhul, simpul - bundhelan tali
bui, penjara - buwi, kunjara
buih - umpluk, unthuk
berbuih - ngumpluk, ngunthuk
bujang - bujang, legan
membujang - mbujang
bujuk - ojok ojok
membujuk - ngojok ojoki
bujur, membujur - mujur
buka - bukak, bikak
dibuka -dibukak
membuka - mbukak
bukan - dudu, guduk, sanes
bukit - punthuk, gumuk
bukti - bukti
membuktikan - mbuktekaken
terbukti - kabukten
buku, kitab - buku, kitab
membukukan - nyathet
buku, ruas - ros
bulan - rembulan, wulan
bulan madu - bulan madu
berbulan bulan - sasen sasen
bulanan - sasen
bulat - bunder
bulatan - bunderan
bulir - wuli, dhompol
bulu - wulu
bulu kening - alis
bulu mata - idep
berbulu - duwe wulu
membului - mbubuti
buluh, bambu - pring, deling
bumbu - bumbu
bumi - bantala, bumi
mengebumikan - mendhem, ngubur, nyarekaken
bumiputra - wong pribumi
bumbung - bumbung. lodhong
buncis - buncis, boncis
buncit - mblendhung
bunda - ibu
bundar - bunder
bundel, bendel - bhendhel
bundel, simpul - bundhel, sindhetan
bunga - kembang, sekar
berbunga - ngembang
membungakan uang - nganakake dhuwit
bungkam - mingkem, bungkem
bungkar - bongkar, rucat
membongkar - mbungkar, mbongkar
bungkil - bungkil
bungkuk - wungkuk, busu
membungkuk - mbungkuk
bungkus - wungkus
dibungkus - dibungkus
membungkus - mbungkus
bunglon - bunglon
bungsil - bluluk
bungsu - ragil, wuragil
buntal, ikan buntal - iwak buntak
buntet, buntu - buntet, bumpet
bunting - meteng, mbobot
buntu - buntet, sumpet
buntung - buntung
buntut - buntut, brutu
berbuntut - duwe buntut
membuntuti - ngetitake
bunuh -pati
dibunuh - dipateni
membunuh - mateni
bunuh diri - nglalu
bunyi - swara, uni, swanten
dibunyikan - diunekake
berbunyi - muni, nyuwara
bunyi bunyian - tetabuhan
burai, terburai - mawur
buram, suram - surem, bureng
buras, memburas - ndopok, ndobos
burik, bopeng - pilak, burik
buronan - buronan, buron
buru, berburu - oyak, mbebedhag
terburu buru - kesusu, kesesa
buruh - buruh, kuli
buruk - elek, ala, awon
burung - manuk, peksi
burut, hernia - ketedhun, kondor
busa, buih - unthuk, umpluk
berbusa - mumpluk, ngumpluk
busana - busana, rasukan
bustan, taman - taman, patamanan
busuk - bosok
busung - busung
busur - gandhewa
buta - picek, wuta
buta, raksasa - buta
butak, keruh - buthek
butir, sebutir - gelintir
butuh - perlu, butuh, betah
membutuhkan - mbutuhake
kebutuhan - kabutuhan
butuh, zakar - peli, palanangan'
butut - mangkak, lawas
buyar - buyar, ambyar
buyut - buyut
babak bunyak - Calar balar
babar - Bersalin/Selesai
babat - Perut (lembu/kerbau)
bacem - Peram/Jeruk
bacin - Berbau (Cth. Bau Ikan Masin/Peram)
badek - Bau Busuk
baji - Pasak
bajing - Tupai
bakol - Bakul/Raga
balang - Baling
balei - Balai
bales - Balas
balie - Balik
balong - Tulang
balot - Balut
banci'an Beralas Sesuatu
bancoh Bancuh
bandol Bandul
banger Bau Bangar
banget Sangat
bangir Mancung
bangkei Bangkai
bangku Kerusi
banting Hempas
bantut Terencat
banyu Air
bapak Bapa/Ayah
baran Marah
bareng Saing/Sama sama
basoh Basuh
bates Batas
batir Kawan
batok Tempurung
battok Dahi
bayem Bayam
bejat Rosak
belarat Merebak/Marak (api)
belasak Terbabas
beling Kaca
belolok Putik Kelapa
belonyok Lembik/Becak
bendeh Kacang Bendi
bendo Benda
bendok Lontar/Baling
bocah Budak
cabang - pang
bercabang - ngepang
cabe - lombok
cabe rawit - lombok rawit
cabe merah - lombonk abang
cabik, robek - suwek
cabir - suwek dawa
cobar cabir - pating sluwir
cabul - cabul, rusuh, saru
cabut - bedhol, bubut
dicabut - dibedhol, dibubuti
tercabut - kebedhol
cacar - cacar
cacat - cacat
caci - pisuh, dhamprat
dicaci - dipisuhi
mencaci - misuhi, nyacad
cacing - cacing
cacingan - cacingan
cadangan - serep, cadhangan
cadar - krodhong
cadas - wadhas
cadik - katir
cagak - cagak, saka, pal
cahaya - cahya, sunar
becahaya - sumunar, sumorot
cair, encer - cuwer, encer
mencair - dadi encer
cairkan dulu - encerke dhisik
cakalang - iwak tongkol
cakap, pintar - pinter
bercakap  - omong omong
cakar - cakar, ceker
dicakar - dicakar
mencakar - nyakar, nggaruk
cakep - bagus, nggantng
cakra - cakra
cakrawala - cakrawala, langit
calo, makelar - calo, blantik
calon - bakal, calon
mencalonkan - nyalonake
cambang - godheg, cambang
cambuk - pecut, cemethi
dicambuk - dipecut
mencambuk - mecut
camilan - camilan, mil milan
campa - macan loreng
campah - campah, kemba
campak, buang - sebrat, kiprat
dicampakkan - disebratke
sakit campak - lara campak
campur - campur, amor, awor
bercampur - nyampur, ngamor
dicampur - dicampur
ikut campur - melu campur, melu melu
mencampur - nyampur, ngamor
campuran - campuran
campur aduk - campur bawur
canai, gerinda - grenda
canag - bendhe
cancut, cawat - cawet
canda - guyon, gojeg
bercanda - geguyon, gojegan
candi - candhi
candu - candu, madat
canggung - kikuk, ewuh
cangking - nyangking
cangkir - cangkir, cingkir
cangklong - cangklong, once
cangkok - cangkok
mencangkok - nyangkok
cangkokan - cangkokan
cangkul - pacul
dicangkul - dipacul
mencangkul - macul
cantelan - canthelan
mencantelkan - nyanthelake
cantik - ayu, elok, edi peni
canting - canthing
cantol - canthol
kecantol - kecanthol
cantrik - cantrik
tercantum - klebu, kamot
cap - cap, merek
capai, tercapai - tekan, katekan
mencapai - tekan, dumugi
capai, capek - liyu, kesel, sayah
capak, remeh - sepele, lirwa
capil, topi - capil, caping
capuk, bopeng - burik, bopeng
cari - golek, pados
mencarikan - nggolekake
mencari - nggoleki
mencari cari - golek golek
mencarter - sewa, nyarter
cat - cet
mengecat - ngecet
catat - cathet
dicatat - dicathet
mencatat - nyathet
catatan - cathetan
catu - cathu, duman
catur, sekak - catur, sekak
catut, mencatut - ngelong
catut, tang - catut, tang
cawan - cawan, lepek
cawat - cawet
cebok, bercebok - cawik, cewok
cebol - cebol, kunthet
cebur, kecebur - njegur, kejegur
diceburkan - dijegurake
menceburkan - njegurake
tercebur - kejegur
cecak - cecak
mencecap - nyicipi, ngicipi
berceceran - kecer, kececeran
cecunguk - coro
cedera, luka - tatu
cegah - penging, penggak
dicegah - dipenging, dipenggak
mencegah - menging, menggak
cegat - cegat, adhang
dicegat - dicegat, diadhang
mencegat - nyegat, ngadhang
cekatan - trengginas, akas
cekcok - grejegan, padu, regejegan, padudon, udur [5]
cekik - tekak, tekek
dicekik - ditekak, ditekek
mencekik - nekak
mencekoki - cekok, nyekoki
cekukan, makan - ceguken
cekung, pipi - kempot
cela, caci - paido, cacad, paiben [6]
mencela - maido, nyacad
celah celah - selan, renggangan
celak mata - celak
bercelak - nganggo celak
celaka - cilaka, apes
kecelakaan - kacilakan
mencelakakan - nyilakakake
celana - kathok, lancingan
celas celus - bludhas bludhus
celeng - celeng
celengan - celengan
nyelengi - nyelengi
celup - celup, wedel
dicelupkan - dicelupake
mencelupkan - nyelupake
celurit - clurit
celurut, tikus - tikus clurut, curut
cemar, kotor - reged
cemara - cemara
cemas - was was, sumelang
cemberut - mrengut
cembung - mblendhuk
cemburu - sujana
cemerlang - gemebyar
cemeti - pecut
mencemooh - ece, ngece
cempaka - cempaka
cempedak - cempedhak
cemplung - cemplung, jegur
dicemplungkan - dicemplungake
kecemplung - kecemplung
mencemplungkan - nyemplungake
cencang - iris, tugel, kethok
mencencang - ngiris, nugel
cendana - cendhana
cendawan - jamur
cenderung - ngeboti
cendol - cendhol
tercengang - kamitenggengen
cengar cengir - cengar cengir
cengeng - gembeng
cengkeh - cengkeh
cengkeram - cekethem
mencengkeram - nyekethem
cengkerama - geguyon, gegojegan
cengkerik - jangkrik
cengkir - cengkir
centeng - centheng, mandhor
cepat - cepet, enggal
ceper, datar - rata, radin
menceracau - nglindur
cerah - padhang, njingglang
cerai - pegat, pisah
bercerai - pegatan. pisahan
diceraikan - dipegat
ceramah - sesorah
cerana - wadhah kinang
cerca, maki - diunek unekake
cerdik - pinter, sugih akal
cerek, teko - ceret, teko
cerewet - crewet
ceria - sumringah
cerih - ampas, sepah
cerita - crita, cariyos
ceriwis - criwis, sugih omong
cermai - creme
cermat - premana, tliti
cermin - pengilon
bercermin - ngilo
ceroboh - grusa grusu, kasar
cerobong - crobomg, pipa
cerutu - srutu
cespleng - cespleng, mandi
cetak - cetak
encetak - nyetak
cetek - cethek, ora jero
mencibir - ngiwi iwi, njudhir
cicak - cecak
cicil - cicil, angsur
dicicil - dicicil, diangsur
mencicil - nyicil, ngangsur
cicip - incip, icip
dicicipi - diincipi
mencicipi - ngincipi
cicit - canggah
ciduk - cidhuk, nyidhuk
cikar - cikar, grobak
cilik, kecil - cilik, alit
cina - cina, tionghwa
cimplonhg - dadhu
cincang - cacah
mencincang - nyacah
cincin - ali ali, sesupe
cinta - tresna, asmara
bercintaan - dhemenan
cipta - cipta
diciptakan - diciptakake
menciptakan - nyiptakake
ciri, tanda - ciri, titen
citarasa - selera
cita cita - gegayuhan
cium - sun ambung, aras
dicium - disun. diambung
mencium - ngesun, ngambung
cium ciuman - ambung ambungan
tercium - ngganda
ciut, menciut - saya cilik, ciut
coba - coba]], [[jajal\**dicoba - dicoba, dijajal
mencoba -njajal, nyoba
cobaan - pacoban
percobaan - njajal. nyoba
coba coba - njajal, pisan pisan
cobek - lemper, cowek
cocok, pas - ceples, cocok
mencocokkan - nyocokake
cocok, tusuk - sujen, sunduk
codot - codhot
cokelat - sokelat, soklat
bercokol - lelungguhan
colek, jawil - jawil,ndulit
mencolek - njawil, ndulit
colok, obor - obor, suluh
colot, mencolot - mencolot, mlumpat
mencolong - nyolong
comberan - peceren, comberan
comblang - germa, jomblang
comot, dekil - reged, gluprut
mencomot - njupuk
compang camping - rowak rawek
condong - dhoyong
congek - kopoken, budheg
congkak - kumalungkung
congkel - cukil, cukit
mencongkel - nyukil, nyukit
contoh - conto, tiru, tuladha
dicontoh - diconto, ditiru
mencontoh - nyonto
contong - conthong
copet - copet, kutil
dicopet - dicopet, dikutil
mencopet - nyopet, ngutil
kecopetan - kecopetan
copot - coplok, copot
cor - ngecor - cor, ngecor, ngecur
corak - gambaran, gagrak
corat coret - orek orek
coret - corek
coreng - corek
coro. kecoa - coro
corong - torong, corong
cuaca - hawa
cubit - jiwit
mencubit - njiwit
cuci - kumbah, girah
cuci baju - ngumbahi, nggirahi
cuci beras - mususi
cuci piring - asah asah, isah isah [7]
cuci kaki - wisuh, wijik, wasuh
cuci muka - raup, suryan
cucu - putu, wayah
bercucu - nduwe putu
cucuk, paruh - cucuk
bercucuran - mbrebes mili
cuil, mencuil - cuwil, nyuwil
cuka - cokak
cukai - cukai, pajeg
cukil - cukil, cungkil
cukong - cukong, bandar
cukup - cukup, cekap
mencukupi - nyukupi
kecukupan - kacukupan
cukur - cungkur, pangkas, paras [8]
bercukur - nyukur, mangkas
dicukur - dicukur
cula - cula, sungu
culas. licik - urik, srei
cuma, hanya - mung, namung
cuma cuma - gratis
cumbu, bercumbu - sembranan, gojegan
cumi cumi - cumi cumi
cungkil - cukil
cuplik - cuplik
curam - njojrog, njuleg
curang - urik
curi - colong
dicuri - dicolong
mencuri - nyolong
pencuri - maling, pandung
kecurian - kemalingan
curiga - sujana, jubriya
dicurigai - dikira, disangka
mencurigai - nyujanani
cuti - perlop - prei, cuti, perlopdacin - dhacin, timbangan
dada - dhadha, jaja [9] [10]
mendadak - dadakan, ujug ujug
dadali - alap alap
dadar, telur - dadar
dadu - dhadhu
tali dadung - dhadhung
daerah - wewengkon, praja
daftar - daptar, urutan
mendaftarkan - ndaptarake
terdaftar - kecathet
dagang - dagang, dodolan
berdagang - dodolan, dagang
dagangan - dagangan
dagel - dhagel, banyol
mendagel - ndhagel, mbanyol
daging - daging
dagu - janggut, kethekan
dahaga - ngelak, salit
dahak - riak
daham - dhehem
berdaham - ndhehem
dahan - pang
dahi - badhuk, palarapan
dahi nonjol - badhuk nonong
dhsyat - hebat
dahulu - biyen, rumiyin
mendahului - ndhisiki
pendahuluan - bebuka, wiwitan
daki, kotoran - bolot, dhangkal
daki, mendaki - manjat, menek
dakon - dhakon, congklak
daksina - kidul
dakwa, tuduh - dakwa, tuduhan
dalal - makelar, blantik
dalam - jero, lebet
kedalaman - jerone
pedalaman - dhaerah kepencil
dalang - dhalang
mendalang - ndhalang
pedalangan - pedhalangan
dalih - alesan
dalil - dalil, panuntun
dam - bendungan, wadhuk
damai - tentrem
damar, pelita - damar, obor, suluh
damba(an) - pengarep arep
mendambakan - ngarep arep
dampar, terdampar - kandhas, kentas
damping - sandhing
berdampingan - sesandhingan, mepet
mendampingi - njejeri, ngancani
damprat, didamprat - dilabrak
dan - lan, karo, kaliyan
dana - dana, bea
danau - tlaga, sendhang
dandan - dandan, dandos
berdandan - macak, ngadisalira
mendadani - ndandani
dandanan - dandanan
dandang - dandang
dangkal - cethek
dangau, gubuk - gubuk
dansa - dhangsa
dapat - oleh, entuk, bisa, pikantuk, saged
terdapat - ana
pendapatan - oleh olehan
kedapatan - ketemu, konangan
dapur - pawon
dara, perawan - prawan, kenya
burung dara - dara
darah - getih, rah, ludira
berdarah - getihen
darat - dharat
mendarat - ndharat
dari - saka, awit, saking
darimana - saka ngendi
daripada - tinimbang
darmawisata - piknik, nglencer
darurat - gawat, kepeksa
dasa - sepuluh
dasar - dhasar, landhesan
dasi - dhasi
daster - dhaster
datang - teka, rawuh
berdatangan - padha teka
kedatangan - ketekan
pendatang - wong manca
datar - rata
dataran - lemah sing rata
datuk - sesepuh, pinisepuh
daun - godhong, ron
berdaun - thukul godhong
daun daunan - godhong godhongan
dawat, tinta - mangsi
dawet, cendol - dhawet, cendhol
dayung - dhayung
mendayung - ndhayung
didayung - didhayung
berdebar - dheg dhegan
debu - bledug, lebu, awu
berdebu - nglebu
dedak - dhedhak
mendedel - dhedhel, ndhedhel
degil - bongol
berdeham - dhehem
dekam - dhekem
dekan - dhekan
mendekap - ndhekep, sikep
dekat - cedhak, caket, celak
berdekatan - jejer
mendekati - nyedhaki
dekil - boloten, reged
dekorasi - rerenggan
delapan - wolu
mendelik - mecicil, mentheleng
delima - dlima
delman - dhokar, andhong
demam - adhem panas, mriang
demi - dhemi
demikian - mangkono, mangkene, mangkana, mekaten[11]
demit - dhemit, setan
dempet - rapet, dhempet
berdempetan - empet empetan
dempul - dhempul
denda - dhendha, ukuman
dendam - dhendham
berdendang - nembang, ura ura
dendeng - dhendheng
dengan - karo, kaliyan
dengar - krungu, mireng
mendengarkan - ngrungokake
didengarkan - dirungokake
pendengar - pamiyarsa
dengki - sreu-i, drengki
dengkul - dhengkul, jengku
mendengkur - ngorok
dentum - gleger
berdenyut - keduten
depa, sedepa - dhepa, sedhepa
depak - nyepak, nendhang
depan - ngarep, ngajeng
didepan - ing ngarep
kedepan - mengarep
depot - dhepot, warung cilik
mendera - sabet, nyabet
derajat - drajat
berderai - mbrebes
deras - deres, santer
derek - kerekan
menderek - ngrerek
deret - baris, larik
berderet - lelarikan
deretan - larikan, barisan
derita - panandang
menderita - nandang, sengsara
penderitaan - kasangsaran
derma - derma, dana
dermaga - dermaga
dermawan - loma
desa - desa, dhusun
desah - klesik, lirih
desak - dhesak, suk
berdesakan - suk sukan
desas desus - kabar angin
berdesir - sembribit (angin)
destar - iket, udheng
detail - jlimet, njelimet
detektif - dhetektif, reserse
detergen - dherjen
detik, sedetik - dhetik, sedhetik
dewa - dewa
dewasa - dewasa
dewi - dewi
di, pada - neng, ing, wonten
dia - dheweke
dhewekne, piyambakipun
diam - meneng, mendel
diam diam - meneng meneng
mendiami - ngenggoni
kediaman - omah, griya
dian - teplok, ublik
berdiang - garang, gegenen
diare - mencret
mendidih - umob
didik - ajar
mendidik - ngajari
pendidikan - pawiyatan'
diesel - dhisel
diet - dhiet
dik, adik - adhi, rayi
dikau - kowe, panjenengan
dikir - dikir
dikit, sedikit - sithik, sekedhik
diktat - dhiktat
dikte - dhikte
mendikte - ndhikte
dinamit - dhinamit
dinamo - dhinamo
dinar - dhinar
dines - dhines
dinding - tembok
dingin - adhem, anyes, asrep
kedinginan - kadhemen
dingklik - dhingklik
dipan - dhipan, amben
diploma - dhiploma, ijazah
diri - awak, badan, salira
dirinya - dheweke, awake
sendiri - dhewe
di sana - ing kana
di sini - ing kene
doa - donga
didoakan - didongakake
mendoakan - ndongakake
berdoa - ndonga
dobel - dhobel, rangkep
dobi - tukang, penatu
dobol, bolong - bolong, bocor
dobrak - mbobol, mbedhah
kue dodol - dhodhol, jenang
dokar - dhokar, andhong
dokoh - liontin
doktrin - dhoktrin
domba - wedhus gibas
domino - dhomino, gaple
dompet - dhompet, slepen
donat - dhonat
donatir - dhonatir, panderma
mendongak - ndhangak
dongeng - dongeng
dongkel - dhongkel
dongkrak - dhongkrak
dongkol - mangkel
donor darah - panyumbang getih
dorong - surung
didorong - disurung
mendorong - nyurung
dos, kardos - dhus, kardhus
dosa - dosa
dosin - losin
dot - dhot
doyan - doyan, dhemen
doyong - dhoyong, miring
drama - lakon sedhih
drum - tambur
dua - loro, kalih
jadi dua - dadi loro
berduaan - sarimbit
dua belas - rolas, kalih welas
dua puluh - rongpuluh, kalih dasa
dua puluh lima - selawe, selangkung
dubur - silit, dhubur
duel, tanding - gelut, tandhing
duda - dhudha
duduk - lungguh, lenggah, pinarak
duga - kira, duga, nyana
menduga - ngira, nduga
diduga - dikira
dugal - ndugal
duha - duha
duhur - lohor, dhuhur
duit, uang - dhuwit, arta
duka cita - susah, sungkawa
dukuh - dhukuh, desa
dukun - dhukun
dukun beranak - dhukun bayi, praji[12]
mendukung - sokong, bantu
dul, dahulu - biyen, dhisik
didahului - didhisiki
mendhului - ndhisiki
dungu - goblok, bodho
dunia - donya, jagad
sedunia - sedonya, sejagad
dupa - menyan, dupa
pedupan - padupan
durhaka - duraka
durat - mutiara
duri -eri
berduri - ana erine
durian - duren
durjana - jahat
dusta - ngapusi, goroh
berdusta - ngapusi
dusun - desa, kampung
pedusunan - padesan
duta - dhuta, utusan
kedutaan - kedhutaan
berduyun duyun - gerombol, ndlidir
duyung, ikan duyung - duyung
ebi - ebi
eceran - eceran, ketengan
mengecer - ngecer, ngeteng
edan, gila - gendheng, edan
edar - ubeng, ider
mengedarkan - ngubengake
mengedari - ngubengi, ngiteri
beredar - mubeng, ngalih ngalih
peredaran - mubenge
edisi, terbitan - weton,
edit, mengedit - mranata
egrang - egrang
eja, mengeja - eja, ngeja
ejan, mengejan - eden, ngeden
ejek, mengejek - ece, ngece
ekonomis - gemi, ora boros
ekor - buntut
berekor - ana buntute
mengekor - ngetutake, ngeloni
eksamen - ujian, pandadaran
eksem - eksem
eksperimen - pacoban, jajalan
ekspedisi - pangiriman barang
eksposisi - pameran
ekspres - cepet, banter
ekstra - ekstra, tambahan
ekuator - katulistiwa
elak, mengelak - endha, ngendhani
elang - wulung, alap alap
elok - apik, edipeni, sae
elon, ngeloni - mihak, ngeloni
elus, mengelus - elus, ngelus
dielus elus - dielus elus
emak, ibu - embok, biyung
emas, mas - emas, jene, kencana
embah - simbah, eyang
embak, mbakyu - mbak, mbakyu
embel embel - embel embel
ember - ember
embun - mbun
emis, pengemis - wong ngemis, kere
emong, ngemong - emong, momong
emosi - emosi, pangrasa
empal - empal
empang, kolam - blumbang
empas, hempas - sebrat, kipat
dihempaskan - dikipatake
menghempaskan - ngipatake
empat - papat, sekawan
empat belas - patbelas, sekawan welas
empat puluh - patang puluh, sekawan dasa
berempat - wong papat
perempatan - prapatan
seperempat - seprapat, sapro sekawan
empedu - peru
empela - rempela
empelas - amplas, amril
emper - emper, tritisan
emping - emping
empuk - empuk
empulur - gabus
enak - enak, sedhep, eco
seenaknya - sak enake
mengenakkan - ngepenakake
keenakan - kesenengen
enam - enem
berenam - jumlahe enem
enam belas - nembelas
enam puluh - sewidak
enau - enau
encer - cuwer
encok - encok, rematik
endap(an) - enep, enepan
mengendapkan - menepake
endap, mengendap - ndingkik
engah, terengah - krenggosan
enggan - wegah, ewuh
engkau - kowe, penjenengan
engkol - engkol
engkong - embah, eyang
engsel - engsel
enom - enom, anom
entah - embuh, duka
entar, sebentar - mengko, mangke
entas, mengentas - ngentas
enteng - entheng, remeh
enyah - lunga, minggat
mengenyahkan - nundhung, nggusah
eram - angrem
mengerami - ngangremi
erang, mengerami - ngangremi
mengerang - sambat, ngirih
erat, ketat - kenceng
ereksi - ngaceng
eret, seret - geret
ercis - kacang kapri
eru - cemara
es - es
esa, tunggal - esa, tunggal
esah, sah - sah, absah
esok - sesuk, mbenjing
keesokannya - esuke
etika - subasita
eyel, mengeyel - ngeyel
faedah - guna, piguna
faham - faham, paham
fajar - bang bang wetan
fakir muskin - fakir miskin
fakta - fakta, kanyatan,kasunyatan
faktur - paktur
fakultas - fakultas
famili - pamili, Keluargo,sedulur,sedherek
fana - ora langgeng
fanatik - panatik
faraj, farji - parji, gawuk, turuk
farak - beda, seje, Benten
fardu, wajib - wajib, kudu, Kedah
farmasi - farmasi
fasih - fasih, apal
fasilitas - kalonggaran
fatihah - patekah
fatwa - patwa, nasehat
feodal - peodal
fertil - subur
film - filem, pelem
filsafat - palsapah
filter - saringan
finis - finis, pungkasan
firasat - firasat, glagat
firdaus - suwarga, firdaus
firman - firman, sabda
fisik - wadhag, jasmani
fitnah - pitenah, Cidra
formal - resmi, formal
formulir - formulir, blangko
foto - potret
foya foya - royal
frustasi - kuciwa
fulus - dhuwit, Arta
fungsi - kalungguhan
berfungsi - migunani
gabah - gabah
gabuk, hampa - ora isi
gabung - kumpul, campur
gabus - gabus
gada - gada
gadai - gadhe
bergadang - lek lekan
gading - gadhing
gadis - prawan, kenya
gaduh, ramai - ribut, rame
gandok - ruang tamu
gerak - obah
habis - entek, telas
dihabiskan - dientekake
menghabisi - mungkasi
menghabiskan - ngrampungake
penghabisan - pungkasan
kehabisan - kentekan
hablur - jendhelan
hadang - adhang, cegat
menghadang - ngadhang, nyegat
hadap - adhep
menghadap - ngadhep
menghadapi - ngadhepi
dihadapkan - diadhepake
berhadapan - arep -arepan
terhadap - marang
hadiah - hadhiah, ganjaran
berhadiah - ana hadhiahe
hadir - ana, teka, wonten
hadirin - para rawuh
menghadiri - nekani, ngrawuhi
hafal - apal
menghafalkan - ngapalake
hafalan - apalan
hai - he, e
haid - haid
hajar, dihajar - digebug
hajat - kajat, niyat
berhajat - duwe kajat
hajatan - kajatan
hajat besar - ngising, bobotan
hajat kecil - nguyuh, tetoyan
haji - kaji
hak, wewenang - hak
hak sepatu - tungkak sepatu
hakikat - hakekat
hakiki - bener, sabenere
hakim - hakim
menghakimi - mutusi prakara
hal - hal, bab, prakara
halal - halal, kalal, sah
menghalalkan - ngalalake
halaman, rumah - latar, pekarangan
halaman, buku - kaca (buku)
halang - alang
menghalangi - ngalangi
halangan - alangan
terhalang - kepalang, kalingan
Penghalang - aling aling
halau - gusah
dihalau - digusah
menghalau - nggusah
halilintar - kilat, thathit
halimun - kabut, pedhut
halte - halte
haluan - ancas, tujuan
sehaluan - setujuan, seancas
halus - alus
hama - ama
hendak - badhe
hujan - jawah
hari - dina, dinten
ia, iya - iya, inggih, injih
mengiakan - ngiyani, mbenerake
ia, dia - dheweke
ialah - iya kuwi, yaiku, yakuwi
iba - mesakake
beriba iba - nrenyuhake
ibadat - ibadah
beribadat - ngibadah
ibarat - umpama
mengibaratkan - ngibaratake
iblis - dhemit, setan
ibu - ibu, biyung ,emak
identik - podo,
ikal - brintik
ikan - iwak
iklan - pariworo
ikut - melu
ingat - eling
ingin - pingin
ini - iki
injak - idek, pidek
intip - injen, nginjen
isap - sedot, nyedot
istirahat - ngaso, laut
itik - bebek
itu - iku, kuwi
jabal, menjabal - ngrampas, mbegal
jabang bayi - jabang bayi
jabar, menjabarkan - nerangake
jabat, menjabat - nyekel gawean, mengku jabatan
jabatan - jabatan
jabat tangan - salaman
jadah - jadah
jadi - dadi, dados
jadi jadian - gawean
kejadian - kedadean
menjadikan - ndadeake
menjadi jadi - saya ndadi
terjadi - dumadi
jalan - dalan, margi
jam - tabuh
jadul - kuno, lawas
jari - driji
jahit - dondom
jahitan - dondoman
menjahit - ndondomi
jenaka - lucu , jenaka
jarum - dom
kamu - kowe,sampeyan, panjenengan,
kepala - Endas, sirah, mustaka
kakek - Embah,
kajaba - Kecuali
kaki - Sikil,suku, samparan
keluar - metu,medal, miyos
kemari - rene, mriki
keringat - riwe
main - dolan
mainan - dolanan
makan - maem, mangan, mbadok, dahar
malam - wengi
mandi - adus, siram
masih - taksih
masuk - mlebu mlebet
mati -seda, tilar dunya, mangkat,
mengikuti - nekani
orang - wong, tiyang
padi - pari, pantun
pensil - potelot
pasung - belok
pendek - cendhak
pergi - lunga, tindak, kesah
puisi - geguritan
pulang - bali, mulih, kondúr
peri
naik - munggah, menek
pelan pelan - alon alon, lirih lirih
pusing - ngelu, nggliyeng
rapuh - Gaprek, getas,
rias - Brai, dandan
rumah - Omah, Griya
saat - nalika
kaki - sikil, suku, samparan,
sampai - tekan,dugi, dumugi
saya - aku kula, dalem
siapa -sinten
sudah -sampun
suka - tresna, seneng, remen,
supaya - amrih, supados
surat - layang,
saudara - sedulur, sedherek, sakadang
semua -sedaya, sedanten
standar - paugeran
sewaktu - sawanci
tanduk - Sungu
tawar - Towo, Anyep, enyang
telinga - Kuping,Talingan
tempurung - Bathok
terima kasih - Matur nuwun
tinggi - Dhuwur, Inggil
tidak - ora, boten
tidur - turu, tilem sare
tuhan - Pengeran, Sembahan, Gusti
tangan - asta
tidur - tilem,turu,sare
tentang - bab
tanya - takon, taken, nyuwun pirsa, tanglet
tinggal -derek, kentun
telah - wis, sampun
tante - bulik
tanpa - tanpa (dibaca tanpo)
tanda - Tenger, tandha
tegak - jejeg,
taring - siung
tapi - ananging
tamu - tamu, Dayoh
timur - Wetan
timba - timbo
ternak - Ingon ingon
tekor - rugi, tombok
terlambat - Telat, kasep
tikar - klasa
takar - taker
Takaran - takeran
tulang - balung
tukar - Ijol,Nglambang
uang - Dhuwit,
ucap - ucap, ujar
ucul - Lepas
ubah - obah,ewah
usaha -usaha
usap - elus
umbel - Ingus
untu - Gigi
wadah - wadah
wajah - rai,
wajan - wajan
wajar - sakperlune, bioso, tumindak sae, sakmadyo
wajib - wajib
waktu - wektu, wedhal, wanci
walaupun - inatase, ewodene, sanajan
wangi - arum
wanita - wanito, wanodyo, setri
warga - wargo
waris - waris
warung - bango, mbango
warna - werna
watak - watak
wewenang - mbahurekso
wibawa - wibowo
wilayah - tlatah
wujud - wujud
sudah - uwisyaitu - yakuwi, yaiku
yakin - percoyo ,pitados
yang - sing